8 24
########################
##m  ###   #######  ####
##    ##   ##   ##  ####
##    ##        ##     e
##    ##    ######  ####
###  ###  ########  ####
###                 ####
######################## 